###############E##############
# #                          #
# #     #################    #
# #     #################    #
#       ##              #    #
##########   #########  #    #
#                            #
#########################    #
#          #           #     #
#          #           #     #
#                      #     #
#          #           #     #
#          #                 #
#          #                 #
##########################   #
# #                          #
# #########################  #
#                         #  #
#         #               #  #
#         #                  #
#         #        ###########
#         #                  #
#         #      #           #
#         #      #           #
#         #      #     ####  #
#         #      #     #  #  #
#                #     #  #  #
##########       #     ####  #
#C               #           #
##############################