#E############################
# #                          #
# #     #################    #
# #     #################    #
#       ##              #    #
##########              #    #
#                            #
#########################    #
#                      #     #
#                      #     #
#                      #     #
#                      #     #
#                            #
#                            #
##########################   #
# #                          #
# #########################  #
#                         #  #
#                         #  #
#                            #
#                  ###########
#                            #
#                #           #
#                #           #
#                #           #
#                #           #
#                #           #
##########       #           #
#C               #           #
##############################